62,62,62,62,62,62,62,62,62,62,62,62,62,62,62,62,62,62,62,62,62,
62,62,62,62,62,62,62,62,62,62,62,62,62,62,62,62,62,62,62,62,62,
62,62,62,62,62,62,62,62,62,62,62,62,62,62,62,62,62,62,62,62,62,
62,62,62,62,62,62,62,62,62,62,62,62,62,62,62,62,62,62,62,62,62,
62,62,62,62,62,62,62,62,62,62,62,62,62,62,62,62,62,62,62,62,62,
62,62,62,62,62,62,62,62,62,62,62,62,62,62,62,62,62,62,62,62,62,
62,62,62,62,62,62,62,62,62,62,62,62,62,62,62,62,62,62,62,62,62,
62,62,62,62,62,62,62,62,62,62,62,62,62,62,62,62,62,62,62,62,62,
62,62,62,62,62,85,74,74,74,74,74,74,86,62,62,62,62,62,62,62,62,
62,62,62,85,74,75,2,1,4,1,1,38,61,62,62,62,62,62,62,62,62,
62,62,62,63,3,1,1,1,2,39,1,39,73,74,86,62,62,62,62,62,62,
62,62,85,75,127,56,56,56,56,56,57,3,1,15,73,74,86,62,62,62,62,
62,62,63,58,59,59,60,55,56,57,69,1,1,3,1,1,73,86,62,62,62,
62,62,63,70,71,71,72,67,116,69,69,1,26,1,1,14,1,73,86,62,62,
62,62,63,82,83,83,84,79,80,81,69,157,158,159,160,1,1,1,61,62,62,
62,62,63,1,139,92,1,91,80,80,81,169,170,171,172,14,38,1,61,62,62,
62,85,75,1,1,142,143,144,1,1,1,181,182,183,184,1,1,2,61,62,62,
62,63,1,1,1,1,1,58,59,59,59,60,1,42,7,20,3,1,61,62,62,
62,63,1,1,1,1,1,70,71,71,71,106,60,1,1,29,1,15,61,62,62,
62,97,51,1,1,1,1,70,71,71,71,71,106,60,1,1,15,1,61,62,62,
62,62,63,1,39,186,1,82,83,83,95,71,71,106,60,21,1,1,73,86,62,
62,62,97,51,39,29,39,96,49,51,70,71,71,71,72,33,1,1,1,61,62,
62,62,62,63,39,29,39,96,73,75,70,71,71,71,72,33,58,59,60,61,62,
62,62,62,63,1,42,7,20,1,1,82,95,71,71,72,33,70,71,72,61,62,
62,62,62,97,50,51,1,42,10,24,2,82,83,83,84,33,82,83,84,61,62,
62,62,62,62,62,97,51,1,1,46,11,11,11,11,11,48,1,1,1,61,62,
62,62,62,62,62,62,63,1,3,4,3,4,1,1,1,5,1,1,1,61,62,
62,62,62,62,62,62,63,1,1,1,2,5,23,27,13,58,59,60,1,61,62,
62,62,62,62,85,74,75,1,58,59,59,60,33,4,58,107,71,72,1,61,62,
62,62,62,85,75,1,1,58,107,71,71,72,33,58,107,71,71,72,1,61,62,
62,62,62,63,1,1,58,107,71,71,71,72,33,70,71,71,94,84,49,98,62,
62,62,85,75,1,58,107,71,71,71,94,84,33,70,71,94,84,1,61,62,62,
62,85,75,1,58,107,71,71,71,71,72,1,33,82,83,84,1,49,98,62,62,
62,63,1,1,70,71,71,71,71,71,72,1,4,1,1,1,1,61,62,62,62,
62,63,1,1,70,71,94,95,71,71,106,60,1,1,1,1,49,98,62,62,62,
62,63,1,1,82,83,84,82,83,95,71,72,1,1,5,49,98,62,62,62,62,
62,97,51,1,1,1,1,1,1,70,71,72,1,1,1,61,62,62,62,62,62,
62,62,97,50,51,1,1,1,1,82,83,84,1,1,49,98,62,62,62,62,62,
62,62,62,62,97,50,50,50,51,1,1,1,1,49,98,62,62,62,62,62,62,
62,62,62,62,62,62,62,62,97,50,50,50,50,98,62,62,62,62,62,62,62,
62,62,62,62,62,62,62,62,62,62,62,62,62,62,62,62,62,62,62,62,62,
62,62,62,62,62,62,62,62,62,62,62,62,62,62,62,62,62,62,62,62,62
